11111111111111111111111111111111
11111111111111111111111111111111
11100000000000011000000000000111
11101111011111011011111011110111
11101111011111011011111011110111
11101111011111011011111011110111
11100000000000011000000000000111
11101111011011111111011011110111
11101111011011111111011011110111
11100000011000011000011000000111
11111111011111011011111011111111
11111111011111011011111011111111
11111111011000000000011011111111
11111111011011100111011011111111
11111111011010000001011011111111
00000000000010000001000000000000
11111111011010000001011011111111
11111111011011111111011011111111
11111111011000000000011011111111
11111111011011111111011011111111
11111111011011111111011011111111
11100000000000011000000000000111
11101111011111011011111011110111
11101111011111011011111011110111
11100011000000000000000011000111
11111011011011111111011011011111
11111011011011111111011011011111
11100000011000011000011000000111
11101111111111011011111111110111
11101111111111011011111111110111
11100000000000000000000000000111
11111111111111111111111111111111